▛▀S▀▀▀▀▀▀▀▀▀▀▀▀▀▀▀▀▀▀▜
▌                    ▐
███████ ██████████ ███
▌ █        █    █    ▐
▌          █    ████ ▐
▌ █████   ██         ▐
▌ █             ██████
▌ ███████ █          ▐
▌    █       █ █████ ▐
▌                  █ ▐
▙▄▄▄▄█▄▄▄▄▄▄▄▄▄▄▄▄▄█X▟